LBBBBBBBBBBBBBBBBBBL
L------------------L
LBbBBBBBTBBBBBBBbBBL
L-l-------------l--L
LBBBTBBBBBBBBbBBBBBL
L------------l-----L
L------------l-----L
LBBBBbBBBBBBBBBTBBBL
L----l-------------L
LBBTBBBBBBBbBBBBBBBL
L----------l-------L
LBBBBBBBBBBBBBBBBBBL
L------------------L
L------------------L
L------------------L
L------------------L
L------------------L
L------------------L
L------------------L