----------L----
----------L----
---LT-----L----
---LBBbBBBL----
--LL--l---L----
--LBBBBBBbL----
L-L------lL----
LBBBBBBBBlLBBL-
L--------lL--L-
LBbBBBBBBBBBBL-
L-l----------L-
L-l----------L-
LBBBBLBBLBBBBL-
L----L--L----L-
L----L--L----L-
L---LL--L----L-
L---L---L----L-
L---L---L----L-
L---L---L----L-
L---L---L----L-
L---L---L----L-
L---L---L----L-
L---L---L----L-