----------L----
----------L----
---L-----TL----
---LBBbBBB-----
--LL--l--------
--LBbBBBBbB----
L-L-l----l---L-
LBBBBLBBLBBBBL-
L----L--L----L-
L----L--L----L-
L---LL--L----L-
L---L---L----L-
L---L---L----L-
L---L---L----L-
L---L---L----L-
L---L---L----L-
L---L---L----L-
L---L---L----L-