LBBBBBBBBBBBBBBBBBBL
L------------------L
LBbBTBbBTBBBTBBBbBBL
L-l---l---------l--L
LBBBBBBBBBBBBbBBBBBL
L------------l-----L
L------------l-----L
LBBBBbBBBTBBbBBTBBBL
L----l------l------L
LBBBBBBBBBBbBBTBBBBL
L----------l-------L
LBBBBBBBBBBBBBBBBBBL
L------------------L
L------------------L
L------------------L
L------------------L
L------------------L
L------------------L
L------------------L